xxxxxxxxxxxxxxxxxxxxxxxxxxx
x1111110000222222d00333333x
x111111000022222200c333333x
x1111110000222222000033333x
x111111b00022222200003330dx
x000111000000b000000033300x
xd000000000000000000033300x
x4444444000000000000333300x
x4444444b00000000000333300x
x444444400000b000000333300x
x00004440055555555000b0000x
xc000000005555555500000000x
x666000000555555550000000cx
x66666600b5555555b00000777x
x6666660055555555007777777x
x6666660055555555007777777x
x00000b0055555555007777777x
x000000000000b000007777777x
x008880000000000000000d777x
xd88888000000b00000000000bx
x8888888000099990000000000x
x888888800099999900000aaaax
x888888800099999990000aaaax
x8888888b009999999000baaaax
x888888800000009990000aaaax
x8888888000000d999c000aaaax
xxxxxxxxxxxxxxxxxxxxxxxxxxx