1111111003111100000111111
1111111000111120000001111
1111100000111120000001111
0011100000111111000001103
0000000000000000000001100
0000000000000000000001100
0011111000000000000111100
0311111000000000000000000
0011000000000000000000000
0000000000000000000000000
0000000001111111000000000
1100000001111111000000000
1111000001111111000000001
1111100001111111200000101
1111100011111111200000101
0001100011111111100000111
0000000000000000000000113
0011100000000000000000010
3011110000000000000000000
1111111000000000000000000
1111111000000110000000000
1111112000111110110000001
1111112000100111110000011
1111111000000113000000111
1111111000001111110001111